＃＃＃＃＃＃＃＃＃＃＃＃＃＃＃＃＃＃＃＃　　　　　　＃＃＃＃＃＃＃＃＃＃＃＃＃＃＃＃＃＃
＃　　　　　　　　　　　　　　　　　　　　　　　　　　　　　　　　　　　　　　　　　　＃
＃　　　　　　　　　　　　　　　　　　　　　　　　　　　　　　　　　　　　　　　　　　＃
＃　　　　　　　　　　　　　　　　　　　　　　　　　　　　　　　　　　　　　　　　　　＃
＃　　　　　　　　　　　　　　　　　　　　　　　　　　　　　　　　　　　　　　　　　　＃
＃　　　　　　　　　　　＃＃＃＃＃＃　　　　　　　　　　　　　　　　　　　　　　　　　＃
＃　　　　　　　　　　　　　　　　　　　　　　　　　　　　　　　　　　　　　　　　　　＃
＃　　　　　　敌　　　　　　　　　　　　　　　　　　　　　　　　　　　　　　　　　　　＃
＃　　　　　　　　　　　　　　　　　　　　　　　　　　　　　　　　　　　　　　　　　　＃
＃　　　　　　　　　　　　　　　　　　　　　　　　　　＃＃＃＃＃　　　　　　　　　　　＃
＃　　　　　　　　　　　　　　　　　　　　　　　　　　＃＃＃＃＃　　　　　　　　　　　＃
＃　　　　　　　　　　　　　　　　　　　　　　　　　　＃＃＃＃＃　　　　　　　　　　　＃
＃　　　　　　　　　　　　　　　　　　　　　　　　　　　　　　　　　　　　　　　　　　＃
＃　　　　　　　　　　　　　　　　　　　　　　　　　　　　　　　　　　　　　　　　　　＃
＃　　　　　　　　　　　　　　　　　　　　　　　　　　　　　　　　　　　　　　　　　　＃
＃　　　　　　　　　　　　　　　　　　　　　　　　鸡　　　　　　　　　　　　　　　　　＃
＃　　　　　　　　　　　＃＃＃＃＃＃＃＃＃＃＃　　　　　　　　　　　　　　　　　　　　＃
＃　　　　　　　　　　　　　　　　　　　　　　　　　　　　　　　　　　　　　　　　　　＃
＃　　　　　　　　　　　　　　　　　　　　　　　　　　　　　　　　　　　　　　　　　　＃
＃　　　　　　　　　　　　　　　　　　　　　　　　　　　　　　　　　　　　　　　　　　＃
＃　　　　　　　　　　　　　　　　　　　　　　　　　　　　　　　　　　　　　　　　　　＃
＃　　　　　　　　　　　　　　　　　　　　　　　＃＃＃＃＃＃　　　　　　　　　　　　　＃
＃　　　　　　　　　　　　　　　　　　　　　　　　　　　　　　　　　　　　　　　　　　＃
＃　　　　　　　　　　　　　　　　　　　　　　　　　　　　　　　　　　　　　　　　　　＃
＃　　　　　　　　　　　　　　　　　　　　　　　　　　　　　　　　　　　　　　　　　　＃
＃＃＃＃＃＃＃＃＃＃＃＃＃＃＃＃＃＃＃＃＃＃＃＃＃＃＃＃＃＃＃＃＃＃＃＃＃＃＃＃＃＃＃＃