＃＃＃＃＃＃＃＃＃＃＃＃＃＃＃＃＃＃＃＃　　　＃＃＃＃＃＃＃＃＃＃＃＃＃＃＃＃＃＃＃＃＃
＃　　　　　　　　　　　　　　　　　　　　　　　　　　　　　　　　　　　　　　　　　　＃
＃　　　　　　　　　　　　　　　　　　　　　　　　　　　　　　　　　　　　　　　　　　＃
＃　　　　　　　　　　　　　　　　　　　　　　　　　　　　　　　　　　　　　　　　　　＃
＃　　　　　　　　　　　　　　　　　　　　　　　　　　　　　　　　　　　　　　　　　　＃
＃　　　　　　　　　　　　　　　　　　　　　　　　　　　　　　　　　　　　　　　　　　＃
＃　　　　　　　　　　　　　　　　　　　　　　　　　　　　　　　　　　　　　　　　　　＃
　　　　　　　　　　　　　　　　　　　　　　　　　　　　　　　　　　　　　　　　　　　＃
　　　　　　　　　　　　　　　　　　　　　　　　　　　　　　　　　　　　　　　　　　　＃
　　　　　　　　　　　　　　　　　　　　　　　　　　　　　　　　　　　　　　　　　　　＃
　　　　　　　　　　　　　　　　　　　　　　　　　　　　　　　　　　　　　　　　　　　＃
　　　　　　　　　　　　　　　　　　　　　　　　　　　　　　　　　　　　　　　　　　　＃
＃　　　　　　　　　　　　　　　　　　　　博　　　　　　　　　　　　　　　　　　　　　　
＃　　　　　　　　　　　　　　　　　　　　　　　　　　　　　　　　　　　　　　　　　　　
＃　　　　　　　　　　　　　　　　　　　　　　　　　　　　　　　　　　　　　　　　　　＃
＃　　　　　　　　　　　　　　　　　　　　　　　　　　　　　　　　　　　　　　　　　　＃
＃　　　　　　　　　　　　　　　　　　　　　　　　　　　　　　　　　　　　　　　　　　＃
＃　　　　　　　　　　　　　　　　　　　　　　　　　　　　　　　　　　　　　　　　　　＃
＃　　　　　　　　　　　　　　　　　　　　　　　　　　　　　　　　　　　　　　　　　　＃
＃　　　　　　　　　　　　　　　　　　　　　　　　　　　　　　　　　　　　　　　　　　＃
＃　　　　　　　　　　　　　　　　　　　　　　　　　　　　　　　　　　　　　　　　　　＃
＃　　　　　　　　　　　　　　　　　　　　　　　　　　　　　　　　　　　　　　　　　　＃
＃　　　　　　　　　　　　　　　　　　　　　　　　　　　　　　　　　　　　　　　　　　＃
＃　　　　　　　　　　　　　　　　　　　　　　　　　　　　　　　　　　　　　　　　　　＃
＃　　　　　　　　　　　　　　　　　　　　　　　　　　　　　　　　　　　　　　　　　　＃
＃＃＃＃＃＃＃＃＃＃＃＃＃＃＃＃＃＃＃　　　　　　＃＃＃＃＃＃＃＃＃＃＃＃＃＃＃＃＃＃＃