＃＃＃＃＃＃＃＃＃＃＃＃＃＃＃＃＃＃＃＃＃＃＃＃＃＃＃＃＃＃＃＃＃＃＃＃＃＃＃＃＃＃＃＃
＃　　　　　　　　　　　　　　　　　　　　　　　　　　　　　　　＃　　　　　　　　　　＃
＃　　　　　　　　　　　　　　　　　　　　　　　　　　　　　　　＃　　　　　　　　　　＃
＃　　　　　　　　　　　　　　　　　　　　　　　　　　　　　　　＃　　　　　　　　　　＃
＃　　　　　　　　　　　　　　　　　　　　　　　　　　　　　　　＃　　　　　　　　　　＃
＃　　　　　　　　　　　　　　　　　　　　　　　　　　　　　　　＃　　　　　　　　　　＃
＃　　　　　　　　　　　　　　　　　　　　　　　　　　　　　　　＃　　　　　　　　　　＃
＃　　　　　　　　　　　　　　　　　　　　　　　　　　　　　　　＃　　　　　　　　　　＃
＃　　　　　　　　　　　　　　　　　　　　　　　　　　　　　　　＃＃＃＃门门＃＃＃＃＃＃
＃　　　　　　　　　　　　　　　　　　　　　　　　　　　　　　　　　　　　　　　　　　＃
＃　　　　　　　　　　　　　　　　　　　　　　　　　　　　　　　　　　　　　　　　　　＃
＃　　　　　　　　　　　　　　　　　　　　　　　　　　　　　　　　　　　　　　　　　　＃
　　　　　　　　　　　　＃　　　　　　　　　　　　　　　　　　　　　　　　　　　　　　＃
　　　　　　　　　　　　＃　　　　　　　　　　　　　　　　　　　　　　　　　　　　　　＃
＃　　　　　　　　　　　＃　　　　　　　　　　　　　　　　　　　　　　　　　　　　　　＃
＃　　　　　　　　　　　＃＃＃＃＃＃＃＃＃　　　　　　　　　　　　　　　　　　　　　　＃
＃　　　　　　　　　　　＃　　　　　　　　　　　　　　　　　　　　　　　　　　　　　　＃
＃　　　　　　　　　　　　　　　　　　　　　　　　　　　　　　　　　　　　　　　　　　＃
＃　　　　　　　　　　　　　　　　　　　　　　　　　　　　　　　　　　　　　　　　　　＃
＃　　　　　　　　　　　　　　　　　　　　　　　　　　　　　　　　　　　　　　　　　　＃
＃　　　　　　　　　　　　　　　　　　　　　　　　　　　　　　　　　　　　　　　　　　＃
＃　　　　　　　　　　　　　　　　　　　　　　　　　　　　　　　　　　　　　　　　　　＃
＃　　　　　　　　　　　　　　　　　　　　　　　　　　　　　　　　　　　　　　　　　　＃
＃　　　　　　　　　　　　　　　　　　　　　　　　　　　　　　　　　　　　　　　　　　＃
＃　　　　　　　　　　　　　　　　　　　　　　　　　　　　　　　　　　　　　　　　　　＃
＃＃＃＃＃＃＃＃＃＃＃＃＃＃＃＃＃＃＃＃＃＃＃＃＃＃＃＃＃＃＃＃＃＃＃＃＃＃＃＃＃＃＃＃